Salesforce: Patrick McDonnell (patrick.mcdonnell@salesforce.com), Ashley Petersen (ashley.petersen@salesforce.com)
Microsoft: UCI recruiter - Kim N (kimngu@microsoft.com), Holly Hamilton (a-holham@microsoft.com), Dave Cotter (dacotter@microsoft.com), Mike Martinsen (mikm@microsoft.com)
Facebook: Jacqueline Tran (jacquelinetran@fb.com), Bill Haughney (bhaughney@fb.com)
Adobe: Nora Kobashigawa (nkobashi@adobe.com)
Amazon:  Ashleigh Potter (ashp@amazon.com), Leo Pichette(leop@amazon.com), Andrew Windham(awwindha@amazon.com)
TripAdvisor: Elizabeth Thomas (ethomas@tripadvisor.com)
Lending Club: Sabrina Liem (sliem@lendingclub.com>
LinkedIn:  Garrett Yacovone (gyacovone@linkedin.com)
Target: Lloyd Claus (lloyd.clausen@target.com)
Walmart and Walmart Labs:
Sears Holdings: Louis Deli (louis.Deli@searshc.com)
Twitter: Janet Ikpa (janetikpa@twitter.com) , Victoria Barry (victoria@twitter.com)
Google: Bixby Elliot (belliot@google.com), Adrianne Velasco (adrianne@google.com), Grace Lim (gracelim@google.com), Andres Medina
Cisco: Adriana Murray (achaparr@cisco.com)
VMWare: Shawn Sigona (ssigona@vmware.com)
Canon: Nancy Rosen (nrosen@cusa.canon.com)
Citrix: Faby Moreau (faby.moreau@citrix.com)
Broadcom: Chara Law (claw@broadcom.com)
Qualcomm: Sydney Horner (c_shorne@qualcomm.com)
Microsemi: Anna Norris (anna.norris@microsemi.com)
Knowles: Michelle Chambers (michelle.chambers@knowles.com)
Ericsson: Micheal Barnum (michael.barnum@ericsson.com)
ESRI: Lara McLaughlin (lmclaughlin@esri.com)
SAP Labs: James McKinstry (james.mckinstry@sap.com)
SAMSUNG RESEARCH AMERICA : Sarah Tapia (s1.brodsky@samsung.com)
Thales: SANCHEZ Joshua (Joshua.SANCHEZ@us.thalesgroup.com)
Cirro: Theresa Jackson (tjackson@cirro.com)
Fidessa: Alena Pustylnik (Alena.Pustylnik@fidessa.com)
Kaiser Permanente: Luke Scanlon (luke.scanlon@kp.org)
ZS Associates: Brin Rustin (brin.rustin@zsassociates.com)
Cylance:  Milly (mchristmann@cylance.com) xx
Canon: Bajo, Allison (ABajo@ciis.canon.com)
Black Knight Financial Services: Daisy Dias (Daisy.Dias@bkfs.com)
Tableau : Michael Ashe(mashe@tableau.com)
Marin Software : Dave Hannah(dhannah@marinsoftware.com)
Zillow : Jenafer Park (jenaferp@zillow.com)
Tibco :  Johnny Borchardt (joborcha@tibco.com) 
MapR: Kiki Beach Kurvin (kbeach@maprtech.com)
Verizon DataLabs: Angelle Horste (angelle.horste@verizon.com)
Uber: Lindsey (lindseyg@uber.com)
Spotify: George McLellan (georgemclellan@spotify.com)